1111111111111111111EF1
10000LLLL0000000100001
100000LLLLL0000L1L0001
10010001L00000LL111001
1001000100010000100001
10010001000100001000L1
I00100000L010000100LL1
I0010000LLD10000100111
111111111111000L1000L1
10000000000000LL100001
1000100L01111111100001
1L0010LLL1000000100111
10001000L100000000L0D1
100L10000000000LLLLLL1
10LL1LLL000100LLLLLLL1
1D0L1LL000010LLLLLLLL1
1111111111111111111111